OOOP PMPP PPPO OOOO
OOPH HPPP PFFF PPOO
OPPP PPMP PPOO OPPO
OPPM MMPP PPOO PPPP
OOOP PBPP HHPP PPOO
OPFP PPPP PPPH HPPO
OOOP PPOO OOOO OOOO
OPPP PPOP PPHP PMOO
OPPP PPOP PHPP RFOO
PFFF PPPP OPFF PPPP
PPPP PPPP OOOP PPPP
OPPM MMPP PPOO OOOO
OOPP PPPP FFPP PPOO
OOOO PPPP PPPP POOO
OOPP PHHP POOO OOOO
OOOO OPPP PPPP PPOO
